11111111111111111111111111
10010000000C110010000000C1
100C0111110011000011C11C01
10000000010000000000000001
10000000101000000000000001
10000001C0C100000000000001
10000000101000000000000001
10000000101000000000000001
10000001C0C110000000000001
10000000101000000000000001
1P001100E00C1C101100000001
10010000000C110010000000C1
100C0111110011000011C11C01
10000000000000000000000001
10000000101000000000000001
10000001C0C100000000000001
10000000101000000000000001
10000000101000000000000001
10000001C0C110000000000001
10000000101000000000000001
11111111111111111111111111