11111111111111111111111111
10010000000C110010000000C1
100C0111110011000011C11C01
10000000000000000000000001
10000000101CCCCCCCCCCCCCC1
10000001C0C100111111100001
10000000101000111111100111
10000000101000000001110111
10000001C0C110010111100001
10000000101001010111110001
1P001100E000C1C1C110000001
11111111111111111111111111