11111111111111111111111111
10000000E000C0C00000000011
11111111111111111111111111