1111111111111111111111111111111111111111111111111111111111
1000000000000000000000000000000000000000000000000000000001
100000000000000000000P000000000000000000000000000000000001
1000000000000000000000000000000000000000000000000000000001
1000000000000000000000000000000000000000000000000000000001
1E0100000000000000000000000000000000000000000011C000000001
1111111111111111111111111111111111111111111111111111111111